1111111111111111
10V00010000C0011
100C0000PV100011
1101110100111111
1E00000C0V111111
1111111111111111